0 0 0 0 0 0 78 8 8 79 0 0 0 0 0 78 8 8 79 0 0 0 0 0 0 0
0 0 0 0 78 8 9 11 11 7 8 8 79 78 8 9 11 11 7 79 0 0 0 0 0 0
0 0 0 0 6 11 12 14 14 10 11 11 7 9 11 12 14 14 10 7 79 0 0 0 0 0
0 0 0 0 6 14 15 17 17 13 14 14 10 12 14 15 17 17 13 10 4 0 0 0 0 0
0 0 0 0 94 3 18 154 154 16 17 17 13 15 17 18 154 154 16 13 7 8 79 0 0 0
0 0 0 0 0 6 21 153 146 150 154 154 16 18 154 151 144 144 150 16 10 11 4 0 0 0
0 0 0 78 79 94 28 64 43 146 144 144 150 151 144 147 153 153 146 150 13 1 95 0 0 0
0 0 0 6 7 8 9 144 50 43 153 153 146 144 147 43 43 43 149 144 16 4 0 0 0 0
0 0 0 6 11 11 12 147 153 43 132 133 134 153 43 43 43 43 48 144 150 7 8 79 0 0
0 78 8 9 14 14 15 43 43 43 138 143 158 133 134 43 43 64 146 144 144 10 11 7 79 0
0 94 3 1 3 17 18 50 43 43 43 138 139 139 140 43 43 43 43 153 146 1 2 3 4 0
0 0 94 95 6 20 151 147 43 43 43 43 43 43 43 43 171 187 43 71 2 95 0 94 95 0
0 0 0 78 9 133 134 187 43 43 43 43 43 43 43 43 189 43 43 4 0 0 78 8 79 0
78 79 0 6 12 136 158 133 133 134 43 64 43 43 132 133 134 43 71 95 78 8 9 11 7 79
9 7 8 9 15 139 143 136 136 137 43 43 43 43 138 143 137 43 7 8 9 11 12 14 1 95
2 3 11 12 17 171 138 143 136 158 134 43 43 43 43 138 140 152 10 11 12 14 1 2 95 0
0 94 3 1 2 28 189 135 136 136 137 43 43 43 43 43 48 144 13 14 15 17 4 0 78 79
0 0 94 95 78 9 132 159 136 136 137 43 43 43 43 149 144 144 16 17 18 154 7 8 9 4
0 0 0 0 6 12 135 136 136 142 140 43 43 71 2 28 146 144 150 154 151 144 10 11 1 95
0 0 0 0 94 3 138 139 139 140 193 192 43 7 79 6 149 144 147 80 147 187 1 2 95 0
0 0 0 0 0 94 2 28 43 43 71 2 2 3 4 94 28 153 171 71 2 2 95 0 0 0
0 0 0 0 0 0 0 94 2 2 95 0 0 94 95 0 94 2 2 95 0 0 0 0 0 0
