0 0 0 0 0 0 0 0 0 0 0 0 0 78 0 0 79 0
0 0 0 0 0 0 0 0 0 0 0 0 0 6 0 0 4 0
0 0 0 0 0 0 0 0 0 0 0 78 8 9 84 84 7 79
0 0 0 0 0 0 0 0 0 0 0 6 11 12 84 85 10 4
0 0 0 0 0 0 0 0 0 0 0 6 14 15 85 77 13 7
0 0 0 0 0 0 0 0 0 0 78 9 17 18 77 77 16 10
0 0 0 0 0 0 0 0 0 78 9 12 154 151 50 43 19 1
0 78 8 8 79 0 0 0 0 6 12 15 144 147 153 43 43 4
78 9 11 11 7 8 8 79 0 6 15 18 144 148 132 133 134 4
6 12 107 108 10 11 11 7 8 9 18 151 147 132 159 136 137 4
6 15 0 0 13 14 14 10 11 12 21 43 43 135 136 136 137 4
6 18 116 100 16 17 17 13 14 15 43 43 43 138 139 139 140 4
6 21 43 43 19 20 20 16 17 18 43 43 43 43 71 2 2 95
6 43 43 43 43 43 43 19 20 21 43 43 43 71 95 0 0 0
6 43 43 43 43 43 43 43 43 43 43 43 43 4 0 0 0 0
94 28 43 43 43 43 43 43 43 43 43 43 71 95 0 0 0 0
0 94 2 2 2 2 2 2 2 2 2 2 95 0 0 0 0 0
