0 0 0 0 0 0 0 0 0 0 0 0 0 0 0 0 0 0 0 0 0 0 0 0 0 0 78 8 8 8 8 8 8 79 0 0 0 0
0 0 0 0 0 0 0 0 0 0 0 0 0 0 0 0 0 0 0 0 0 0 0 0 0 78 9 17 17 17 17 17 17 7 8 79 0 0
0 0 0 0 0 0 0 0 0 0 0 0 0 0 0 0 78 8 79 0 0 0 0 0 78 9 18 20 20 20 20 20 20 16 17 7 79 0
0 0 0 78 8 8 8 79 0 0 0 0 0 78 8 8 9 11 4 0 0 0 0 0 6 18 21 43 43 43 43 43 43 19 20 16 4 0
0 0 78 9 11 11 11 4 0 0 0 78 8 9 11 11 12 14 7 8 8 8 8 8 9 21 43 43 43 43 43 43 43 43 43 19 4 0
0 0 6 12 14 14 14 7 79 0 0 94 3 12 14 14 15 17 10 11 11 11 11 11 12 43 43 43 43 43 43 43 43 43 43 27 95 0
0 0 6 15 17 17 17 10 7 8 79 0 94 3 17 17 18 154 13 14 14 14 14 14 15 56 57 57 57 47 46 57 47 43 43 4 0 0
0 0 6 18 20 154 154 13 10 11 7 8 8 9 154 154 151 144 16 17 17 17 17 17 18 16 17 17 17 81 83 17 56 47 43 4 0 0
0 78 9 21 29 146 147 16 13 14 10 11 11 12 144 144 144 144 150 20 20 20 20 20 21 19 20 20 20 81 83 20 16 40 27 95 0 0
0 6 12 50 152 64 43 19 16 17 13 14 14 15 144 144 147 46 57 57 57 57 47 43 43 43 46 47 43 81 83 43 19 40 4 0 0 0
0 6 15 144 144 50 43 43 19 20 16 17 17 18 147 153 46 58 17 17 17 17 56 57 57 57 58 56 47 43 43 43 43 40 7 8 8 79
78 9 18 144 144 144 148 43 43 43 19 20 20 21 43 46 58 18 33 33 33 33 16 17 17 17 18 16 40 43 43 43 43 40 16 17 17 4
94 3 151 144 144 147 43 43 43 29 43 43 43 43 43 42 18 34 0 0 0 0 32 33 33 33 34 32 56 47 43 43 43 40 19 20 20 4
0 6 147 153 153 43 71 2 28 47 43 43 43 43 46 58 34 0 0 0 0 0 0 0 0 0 0 38 25 25 25 76 43 40 43 43 43 4
0 6 43 43 43 43 4 0 6 56 57 57 57 57 58 18 0 0 0 0 0 0 0 0 0 0 0 40 43 43 5 42 43 40 43 43 43 4
0 6 43 43 43 71 95 0 6 16 17 17 17 17 18 34 0 0 0 0 0 0 0 0 0 0 38 63 43 43 43 42 43 40 5 43 43 4
0 6 43 43 43 4 0 0 6 32 33 33 33 33 34 0 0 0 0 0 38 25 25 25 25 25 63 43 43 43 46 58 43 40 43 43 27 95
0 94 28 43 43 7 79 0 94 23 0 0 0 0 0 0 0 0 0 0 40 43 43 43 43 43 43 43 46 57 58 18 43 40 27 2 95 0
0 0 6 43 43 10 4 0 0 6 38 25 25 25 25 39 0 0 0 0 56 57 47 46 57 57 57 57 58 17 18 21 43 40 4 0 0 0
0 78 9 43 43 13 4 0 78 9 63 43 43 43 43 62 25 25 25 25 16 17 81 83 17 14 14 14 18 20 21 43 71 2 95 0 0 0
0 6 12 43 43 16 4 0 6 12 43 43 71 2 28 43 43 43 43 43 19 20 81 83 20 17 17 17 21 43 43 43 4 0 0 0 0 0
0 6 15 43 48 150 7 79 94 3 87 77 4 0 6 43 43 43 43 43 43 43 81 83 43 20 20 20 43 43 43 71 95 0 0 0 0 0
0 6 18 48 144 144 10 4 0 6 84 87 4 0 6 43 71 2 28 43 43 43 43 43 43 43 43 43 43 43 43 4 0 0 0 0 0 0
0 6 151 144 144 144 13 4 0 6 84 84 4 78 9 43 7 79 6 43 71 2 2 2 2 2 2 2 2 2 2 95 0 0 0 0 0 0
0 6 144 144 144 147 16 7 79 94 2 2 95 6 12 41 10 4 6 43 4 0 0 0 0 0 0 0 0 0 0 0 0 0 0 0 0 0
0 6 146 144 144 148 19 10 7 8 8 8 8 9 15 122 13 7 9 41 7 79 0 0 0 0 0 0 0 0 0 0 0 0 0 0 0 0
0 94 28 146 147 43 152 13 10 11 11 11 11 12 18 121 16 10 12 121 10 4 0 0 0 0 0 0 0 0 0 0 0 0 0 0 0 0
0 0 6 43 43 48 144 16 13 14 14 14 14 15 21 43 19 13 15 43 13 7 79 0 0 0 0 0 0 0 0 0 0 0 0 0 0 0
0 0 94 28 149 144 144 150 16 17 17 17 17 18 43 43 43 16 18 43 1 2 95 0 0 0 0 0 0 0 0 0 0 0 0 0 0 0
0 0 0 6 149 144 144 144 150 154 154 154 20 21 43 43 43 19 21 43 4 0 0 0 0 0 0 0 0 0 0 0 0 0 0 0 0 0
0 0 0 6 43 146 144 144 144 144 144 147 43 43 43 43 43 43 43 43 4 0 0 0 0 0 0 0 0 0 0 0 0 0 0 0 0 0
0 0 0 94 28 43 146 144 147 153 153 43 43 43 43 43 43 43 43 43 7 79 0 0 0 0 0 0 0 0 0 0 0 0 0 0 0 0
0 0 0 0 94 2 2 2 28 43 43 43 43 71 2 2 28 43 43 71 2 95 0 0 0 0 0 0 0 0 0 0 0 0 0 0 0 0
0 0 0 0 0 0 0 0 94 2 2 2 2 95 0 0 6 87 77 4 0 0 0 0 0 0 0 0 0 0 0 0 0 0 0 0 0 0
0 0 0 0 0 0 0 0 0 0 0 0 0 0 0 0 6 84 87 4 0 0 0 0 0 0 0 0 0 0 0 0 0 0 0 0 0 0
0 0 0 0 0 0 0 0 0 0 0 0 0 0 0 0 6 84 84 4 0 0 0 0 0 0 0 0 0 0 0 0 0 0 0 0 0 0
0 0 0 0 0 0 0 0 0 0 0 0 0 0 0 0 94 2 2 95 0 0 0 0 0 0 0 0 0 0 0 0 0 0 0 0 0 0
