0 0 0 0 0 0 0 0 0 0 0 0 0 78 8 8 8 79 0 0 0 0 0 0 0 0 0 0 0 0 0 0 0 0 0 0 0 0 0 0 0 0 0 0 0 0 0 0 0 0 0
0 0 0 0 0 0 0 0 0 0 78 8 8 9 11 11 11 7 79 0 0 0 0 0 0 0 78 0 0 79 0 0 0 0 0 0 0 0 0 0 0 0 0 0 0 0 0 0 0 0 0
0 0 0 0 0 78 8 8 8 8 9 11 11 12 14 14 14 10 4 0 0 0 0 0 0 0 6 0 0 4 0 0 0 0 0 0 0 0 0 0 0 0 0 0 0 0 0 0 0 0 0
0 0 0 78 8 9 11 11 11 11 12 14 14 15 17 17 17 13 4 0 78 8 79 0 0 0 6 0 0 4 0 0 0 0 0 0 0 0 0 0 0 0 0 0 0 0 0 0 0 0 0
0 0 78 9 11 12 14 14 14 14 15 17 17 18 20 20 20 16 7 8 9 11 4 0 78 8 9 84 84 4 0 0 0 0 0 0 0 0 0 0 0 0 0 0 0 0 0 0 0 0 0
0 0 6 12 14 15 17 17 17 17 18 154 20 21 43 43 43 19 10 11 12 14 7 8 9 11 12 84 85 7 8 79 0 0 0 0 0 0 0 0 0 0 0 0 0 0 0 0 0 0 0
0 0 6 15 17 18 20 20 20 20 151 147 43 43 43 29 43 64 13 14 15 17 10 11 12 14 15 85 77 10 11 4 0 0 0 0 0 0 0 0 0 0 0 0 0 0 0 0 0 0 0
0 78 9 18 154 21 43 46 57 57 47 43 29 43 171 43 43 43 16 17 18 154 13 14 15 17 18 77 77 13 14 4 0 0 0 0 0 0 0 0 0 0 0 0 0 0 0 0 0 0 0
0 6 12 151 147 43 46 58 17 17 56 47 43 43 43 43 187 43 19 20 151 144 16 17 18 154 151 144 50 16 17 4 0 0 0 0 0 0 0 0 0 0 0 78 8 8 8 8 79 0 0
0 6 15 147 43 46 58 18 33 33 1 2 2 28 43 43 43 189 43 41 153 153 19 20 21 146 144 144 144 150 20 7 79 0 0 78 0 0 79 0 0 0 78 9 11 11 11 11 7 79 0
0 6 18 148 43 42 18 34 22 2 95 0 0 94 2 28 43 43 43 121 43 43 43 43 43 43 153 146 144 144 144 10 4 0 0 6 0 0 4 0 0 78 9 12 14 14 14 14 10 4 0
0 6 21 43 46 58 34 22 95 78 0 0 79 0 78 9 43 43 43 43 43 43 43 43 132 134 43 71 2 2 2 3 4 0 0 6 84 84 4 0 0 6 12 15 17 17 17 17 13 4 0
0 6 43 43 42 18 0 4 0 6 0 0 4 78 9 12 41 43 43 43 43 29 43 132 159 137 43 4 0 0 0 94 95 0 0 6 84 84 4 0 0 6 15 18 20 20 20 20 16 7 79
0 6 50 46 58 34 0 4 0 6 0 0 4 6 12 15 121 64 29 29 43 43 43 135 136 137 43 4 78 0 0 79 0 0 0 6 84 85 4 0 0 6 18 21 43 43 43 43 19 10 4
0 6 144 42 18 0 0 7 8 9 84 84 7 9 15 18 80 80 64 43 80 43 43 138 139 140 71 95 6 0 0 4 0 0 0 6 85 77 7 8 8 9 21 43 43 43 43 43 43 1 95
0 6 144 42 34 0 0 10 11 12 84 85 10 12 12 21 64 43 29 29 57 57 57 57 47 64 7 8 9 84 84 7 8 8 8 9 57 57 10 11 11 12 43 43 71 2 28 43 43 4 0
0 6 147 62 39 0 0 13 14 15 85 77 13 15 15 40 43 29 46 58 17 17 17 17 40 29 10 11 12 84 85 10 11 11 11 12 33 33 13 14 14 15 43 43 4 0 6 87 77 4 0
0 6 148 43 62 25 25 16 17 18 77 77 16 12 18 40 43 46 58 18 33 33 33 33 56 57 13 14 15 85 77 13 14 14 14 15 0 0 16 17 17 18 43 43 4 0 6 84 87 4 0
0 6 148 43 43 43 43 19 20 21 64 43 19 15 34 40 43 42 18 34 0 0 0 0 16 17 10 11 18 77 77 16 17 11 11 12 25 25 19 20 20 21 43 43 7 79 6 84 84 4 0
78 9 50 43 64 43 43 43 43 43 43 43 42 18 0 40 43 42 34 0 0 0 0 0 32 33 13 14 21 43 43 19 20 14 14 15 56 47 43 43 43 43 43 43 10 4 94 2 2 95 0
6 1 2 28 43 29 43 46 57 57 57 57 58 34 0 40 46 58 0 0 0 0 0 0 0 0 16 17 40 43 43 43 42 17 17 18 16 56 57 57 57 47 43 43 13 4 0 0 0 0 0
94 95 0 94 2 28 57 58 17 17 17 17 18 0 0 40 42 18 0 0 0 0 0 0 0 0 32 33 40 43 43 43 42 33 33 34 32 16 17 17 17 56 47 43 16 4 0 0 0 0 0
0 0 0 0 0 6 17 18 33 33 33 33 34 0 38 63 42 34 0 0 0 0 0 0 0 0 0 0 40 29 43 43 62 39 0 0 0 32 33 33 33 16 40 43 19 7 8 79 0 0 0
0 0 0 0 0 6 33 34 0 0 0 38 25 25 63 43 42 0 0 0 0 0 0 0 0 0 22 2 2 2 2 28 43 62 39 0 0 0 0 0 0 32 40 43 43 10 1 95 0 0 0
0 0 0 0 0 6 0 0 38 25 25 63 43 43 43 43 62 25 25 39 0 38 25 39 0 22 95 0 0 0 0 6 43 43 42 0 0 0 0 0 0 38 63 29 71 3 4 0 0 0 0
0 0 0 0 0 94 23 0 40 43 43 64 43 43 43 43 43 132 134 62 25 63 43 62 39 4 0 0 0 0 0 94 28 43 62 39 0 0 0 0 38 63 43 43 4 94 95 0 0 0 0
0 0 0 0 78 8 9 0 40 43 43 43 43 43 29 80 132 159 158 134 43 29 43 43 62 4 0 0 0 0 0 0 6 64 43 62 25 25 25 25 63 43 43 43 4 0 0 0 0 0 0
0 0 0 0 6 1 2 2 2 2 28 43 43 43 80 43 135 142 139 140 43 43 43 43 71 95 0 78 0 0 79 0 6 43 80 43 43 43 43 43 43 43 71 2 95 0 0 0 0 0 0
0 0 0 0 94 95 0 0 0 0 94 2 28 43 43 43 138 140 71 2 2 2 2 2 95 0 0 6 0 0 4 0 6 50 43 43 43 43 43 43 43 132 4 0 0 0 0 0 0 0 0
0 0 0 0 0 0 0 0 0 0 0 0 6 43 43 43 43 64 4 0 0 0 0 0 0 0 0 6 0 0 4 0 6 144 148 43 43 43 43 132 133 159 4 0 0 0 0 0 0 0 0
0 0 0 0 0 0 0 0 0 0 0 0 94 28 43 43 43 71 95 0 0 0 0 0 78 8 8 9 84 84 7 8 9 144 50 43 43 29 43 135 136 136 7 79 0 0 0 0 0 0 0
0 0 0 0 0 0 0 0 0 0 0 0 0 94 28 43 43 4 0 0 0 0 0 78 9 11 11 12 84 85 10 11 12 144 144 148 43 43 71 2 2 2 3 4 0 0 0 0 0 0 0
0 0 0 0 0 0 0 0 0 0 0 0 0 0 6 87 77 4 0 0 0 0 0 6 12 14 14 15 85 77 13 14 15 144 147 71 2 2 95 0 0 0 94 95 0 0 0 0 0 0 0
0 0 0 0 0 0 0 0 0 0 0 0 0 0 6 84 87 4 0 0 0 0 78 9 15 17 17 18 77 77 16 17 18 147 43 4 0 0 0 0 0 0 0 0 0 0 0 0 0 0 0
0 0 0 0 0 0 0 0 0 0 0 0 0 0 6 84 84 4 0 0 0 0 6 12 18 20 20 21 43 43 19 20 21 43 43 4 0 0 0 0 0 0 0 0 0 0 0 0 0 0 0
0 0 0 0 0 0 0 0 0 0 0 0 0 0 94 2 2 95 0 0 0 0 6 15 21 43 43 43 29 43 43 43 43 43 43 4 0 0 0 0 0 0 0 0 0 0 0 0 0 0 0
0 0 0 0 0 0 0 0 0 0 0 0 0 0 0 0 0 0 0 0 0 0 94 2 28 43 43 43 43 43 43 43 43 43 71 95 0 0 0 0 0 0 0 0 0 0 0 0 0 0 0
0 0 0 0 0 0 0 0 0 0 0 0 0 0 0 0 0 0 0 0 0 0 0 0 94 28 192 193 43 43 43 43 71 2 95 0 0 0 0 0 0 0 0 0 0 0 0 0 0 0 0
0 0 0 0 0 0 0 0 0 0 0 0 0 0 0 0 0 0 0 0 0 0 0 0 0 6 190 80 43 71 2 2 95 0 0 0 0 0 0 0 0 0 0 0 0 0 0 0 0 0 0
0 0 0 0 0 0 0 0 0 0 0 0 0 0 0 0 0 0 0 0 0 0 0 0 78 9 71 2 2 95 0 0 0 0 0 0 0 0 0 0 0 0 0 0 0 0 0 0 0 0 0
0 0 0 0 0 0 0 0 0 0 0 0 0 0 0 0 0 0 0 0 0 0 0 0 94 2 95 0 0 0 0 0 0 0 0 0 0 0 0 0 0 0 0 0 0 0 0 0 0 0 0
