0 0 0 0 0 0 0 0 0 0 0 0 78 8 8 79 0 0 0
0 0 0 0 0 0 0 0 0 0 78 8 9 11 11 7 8 79 0
0 0 0 0 0 0 0 0 78 8 9 11 12 14 14 10 11 4 0
0 0 0 0 0 0 0 78 9 11 12 14 15 17 17 13 14 7 79
0 0 0 0 0 0 78 9 12 14 15 17 18 154 154 16 17 10 4
0 0 0 0 0 0 6 12 15 17 18 154 151 144 144 150 154 1 95
0 0 0 0 0 78 9 15 18 154 151 144 147 146 144 144 144 4 0
0 0 0 0 0 6 12 18 151 144 144 147 43 43 153 153 146 4 0
0 0 0 0 0 6 15 151 147 153 153 71 2 28 43 43 71 95 0
0 0 0 0 0 6 18 147 43 43 48 4 0 6 87 77 4 0 0
0 78 8 8 8 9 21 43 43 71 2 95 0 6 84 87 4 0 0
78 9 17 14 11 12 148 43 43 4 0 0 0 6 84 84 4 0 0
6 18 20 17 14 15 148 43 43 4 0 0 0 94 2 2 95 0 0
6 21 25 26 17 18 43 43 43 4 0 0 0 0 0 0 0 0 0
6 40 43 42 20 21 43 43 71 95 0 0 0 0 0 0 0 0 0
6 40 43 42 43 43 43 43 4 0 0 0 0 0 0 0 0 0 0
94 28 57 58 43 43 43 43 4 0 0 0 0 0 0 0 0 0 0
0 94 2 2 28 43 43 71 95 0 0 0 0 0 0 0 0 0 0
0 0 0 0 94 2 2 95 0 0 0 0 0 0 0 0 0 0 0
