0 0 0 0 0 0 0 0 0 0 0 0 0 0 0 0 0 0 0 0 0 0 0 0 0 78 8 8 8 79 0 0 0 0 0 0 0 0 0 0 0 0 0
0 0 0 0 0 0 0 0 0 0 0 0 0 0 0 0 0 0 0 0 0 0 0 78 8 9 11 11 11 7 8 8 79 0 0 0 0 0 0 0 0 0 0
0 0 0 78 8 8 8 79 0 0 0 0 0 0 0 0 0 0 0 0 0 0 78 9 11 12 14 14 14 10 11 11 4 0 0 6 141 4 0 0 0 0 0
0 78 8 9 11 11 11 7 79 0 0 0 0 0 0 0 0 0 0 0 0 0 6 12 14 15 17 17 17 13 11 11 7 79 0 6 141 4 0 0 0 0 0
78 9 11 12 14 14 14 10 7 79 0 0 0 0 0 0 0 0 0 0 0 0 6 15 17 18 20 20 20 16 14 14 10 4 0 6 141 4 0 0 0 0 0
6 12 14 15 17 17 17 13 10 4 0 0 0 0 0 0 0 0 0 0 0 0 6 18 20 21 43 43 43 19 17 17 13 4 0 6 141 4 0 0 0 0 0
6 15 17 18 20 20 20 16 13 4 0 0 0 0 78 8 8 79 0 0 0 78 9 21 43 43 43 43 46 58 33 33 16 4 0 6 141 4 0 0 0 0 0
6 18 20 21 43 43 43 19 16 7 79 0 0 0 6 11 11 7 8 8 8 9 12 43 43 43 43 43 42 18 0 38 19 4 78 9 141 4 0 0 0 0 0
6 21 43 43 43 43 43 43 19 10 7 8 8 8 9 14 14 10 11 11 11 12 15 43 43 43 71 2 2 2 23 40 43 7 9 12 141 4 0 0 0 0 0
6 43 43 43 43 43 43 43 43 13 10 11 11 11 12 17 17 13 14 14 14 15 18 43 43 43 7 79 0 0 6 87 77 1 2 3 141 7 79 0 0 0 0
94 28 43 43 71 28 43 43 43 16 13 14 14 14 15 20 20 16 17 17 17 18 21 43 43 43 10 4 0 0 6 84 87 4 0 6 141 10 4 0 0 0 0
0 6 87 77 4 94 28 43 43 19 16 17 17 17 18 43 43 19 20 20 20 21 43 43 43 43 1 95 0 0 6 84 84 4 0 6 141 13 4 0 0 0 0
0 6 84 87 4 78 9 43 43 43 19 20 20 20 21 43 43 43 43 43 43 43 43 43 43 43 4 0 0 0 94 2 2 95 0 6 141 10 7 79 0 0 0
0 6 84 84 4 6 12 43 43 43 43 43 43 43 43 46 57 57 47 43 43 71 2 28 43 43 4 0 0 0 0 0 0 0 0 6 141 13 10 4 0 0 0
0 94 2 2 95 6 15 43 43 43 43 43 46 57 57 58 17 17 40 29 43 4 0 6 87 77 4 0 0 0 0 0 0 0 0 6 141 128 13 7 79 0 0
0 0 0 0 0 94 2 2 28 43 43 46 58 17 17 18 33 33 56 57 43 7 79 6 84 87 4 0 0 0 0 78 8 8 8 9 141 125 10 10 4 0 0
0 0 0 0 0 0 0 0 94 28 43 42 18 33 33 34 0 0 16 17 56 10 4 6 84 84 4 0 0 0 0 6 11 11 11 12 141 145 13 13 4 0 0
0 0 0 0 0 0 0 0 0 94 28 58 34 0 0 0 0 0 32 33 16 13 4 94 2 2 95 0 0 78 8 9 14 14 14 15 141 44 128 10 7 8 79
0 0 0 0 0 78 0 0 79 0 6 18 0 0 0 0 0 0 0 0 32 10 4 0 0 0 0 0 0 6 11 12 17 17 17 18 25 170 125 13 10 11 4
0 0 0 0 0 6 0 0 4 0 6 34 0 0 0 0 0 0 0 0 0 13 4 0 0 0 0 0 78 9 14 15 154 154 154 21 43 42 141 128 13 1 95
0 0 0 0 0 6 0 0 4 78 9 0 0 0 0 0 0 0 0 0 0 16 4 0 0 0 0 0 6 12 17 18 144 144 144 148 43 42 141 125 10 4 0
0 0 0 0 0 6 84 84 7 9 12 25 39 0 0 0 0 0 0 0 0 32 7 8 8 8 8 8 9 15 154 151 144 144 147 43 43 42 141 145 13 4 0
0 0 0 0 0 6 84 85 10 12 15 43 62 25 25 39 0 38 25 25 25 39 10 11 11 11 11 11 12 18 80 146 144 147 43 43 46 58 141 44 128 4 0
0 0 0 0 0 6 85 77 13 15 18 43 43 43 43 43 25 43 43 43 43 62 13 14 14 14 14 14 15 151 50 43 153 43 43 43 42 99 44 44 125 4 0
0 0 0 0 0 6 77 77 16 18 21 64 43 43 43 43 43 43 43 43 43 43 16 17 17 17 17 17 18 144 148 43 43 43 43 43 42 97 44 44 145 4 0
0 0 0 0 0 6 43 43 19 21 43 43 43 43 43 43 43 43 43 132 133 134 19 20 20 20 20 154 151 147 43 29 43 71 2 2 2 52 44 44 145 4 0
0 0 0 0 0 94 28 43 43 43 43 43 43 71 2 2 2 2 28 138 139 140 43 43 43 64 43 146 147 43 43 43 71 95 0 0 0 6 141 44 145 4 0
0 0 0 0 0 0 6 43 43 43 43 43 71 95 78 0 0 79 94 2 28 43 43 43 43 43 71 2 2 2 2 2 95 0 0 0 0 6 141 44 145 4 0
0 0 0 0 0 0 94 28 29 43 43 43 4 0 6 0 0 4 0 0 94 28 43 43 71 2 95 0 0 0 0 0 0 0 0 0 0 6 141 44 145 4 0
0 0 0 0 0 0 0 94 2 2 28 71 95 0 6 0 0 4 0 0 0 6 87 77 4 0 0 0 0 0 0 0 0 0 0 0 0 6 141 44 145 4 0
0 0 0 0 0 0 0 0 0 0 94 95 0 0 6 84 84 4 0 0 0 6 84 87 4 0 0 0 0 0 0 0 0 0 0 0 0 6 141 44 145 4 0
0 0 0 0 0 0 0 0 0 0 0 0 0 0 6 84 84 7 79 0 0 6 84 84 4 0 0 0 0 0 0 0 0 0 0 0 0 6 141 44 145 4 0
0 0 0 0 0 0 0 0 0 0 0 0 0 0 6 84 84 1 95 0 0 94 2 2 95 0 0 0 0 0 0 0 0 0 0 0 0 6 141 44 145 4 0
0 0 0 0 0 0 0 0 0 0 0 0 0 0 6 84 84 4 0 0 0 0 0 0 0 0 0 0 0 0 0 0 0 0 0 0 0 6 141 44 145 4 0
0 0 0 0 0 0 0 0 0 0 0 0 0 78 9 84 85 4 0 0 0 0 0 0 0 0 0 0 0 0 0 0 0 0 0 0 0 0 0 0 0 0 0
0 0 0 0 0 0 0 0 0 0 0 0 0 6 12 85 77 4 0 0 0 0 0 0 0 0 0 0 0 0 0 0 0 0 0 0 0 0 0 0 0 0 0
0 0 0 0 0 0 0 0 0 0 0 0 0 94 3 43 43 4 0 0 0 0 0 0 0 0 0 0 0 0 0 0 0 0 0 0 0 0 0 0 0 0 0
0 0 0 0 0 0 0 0 0 0 0 0 0 0 6 103 103 4 0 0 0 0 0 0 0 0 0 0 0 0 0 0 0 0 0 0 0 0 0 0 0 0 0
0 0 0 0 0 0 0 0 0 0 0 0 0 0 6 130 130 4 0 0 0 0 0 0 0 0 0 0 0 0 0 0 0 0 0 0 0 0 0 0 0 0 0
0 0 0 0 0 0 0 0 0 0 0 0 0 0 94 2 2 95 0 0 0 0 0 0 0 0 0 0 0 0 0 0 0 0 0 0 0 0 0 0 0 0 0
